5 5
0 3
0  0  S  0  B
0  S  0  BS 0
0  0  S  0  B
0  0  0  G  0
0  0  0  0  0
