7 7
6 0
0 G 0 0 0 0 0
0 0 B 0 0 S 0
0 B 0 B S 0 S
0 0 B 0 0 S 0
0 0 0 0 0 0 0
0 0 0 0 0 0 0
0 0 0 0 0 0 0
